definitions = "definition.csv"
provinces = "provinces.bmp"
positions = "positions.txt"
terrain = "terrain.bmp"
rivers = "rivers.bmp"
topology = "heightmap.heightmap"
adjacencies = "adjacencies.csv"
areas = "areas.txt"
regions = "regions.txt"
ports = "ports.csv"
climate = "climate.txt"





sea_zones = LIST { 
1 3 10 130 32 38 378 185 322 1218 29 25 5536 4 18 11 14 17 15 12 5 6 24 28 26 19 33 40 31 193 7 8 16 9 13 1969 2551 2417 4291 4015 1478
5498 5164 5526 5514 5134 5020 5375 5470 5507 5503 5509 5518 5523 5521 5527 5481 2 5506 5490 5478 5451 5528 5519 3864 3242 2532 1649 1466 1100 382 395 190 309 58 53 55 30 68 134
1048 1355 1734 1815 2465 1831 2847 1523 1263 1389 1351 36 46 275 21 199 77 47 479 423 556 437 363 377 519 907 712 836 263 1468 1459 1301 720 569 557 312 304 107 127 42 27 20 22 
3100 3943 4480 4920 5193 5302 3514 5059 2399 4036 5395 4347 5529 5530 5531 4765 4845 4827 4804 5117 5023 5218 5387 5158 5165 4859 4710 5441 5225 4963
2648 2527 2283 2173 1918 2179 2324 1748 1984 2188 2294 2307 1631 1844 2137 1575 1881 1936 4991 4855 5224 5380 5342 5515 5513 5471 5475 5438 5330 5480 5483 5102 5493 5012 5294 5442 5206
751 996 1287 1309 1429 1191 731 771 1576 1393 1479 1570 1382 883 1021 1354 629 634 863 1137 386 346 396 365  808 615 457 499 373 693 439 344 218
1676 1707 1589 1511 1662 1314 1144 805 607 388 565 1806 1626 1334 969 56 168 272 335 330 177 109 131 213 351 341 501 515 361 197 333 342 497 362 4928
2575 2814 3117 3640 4086 2676 3150 3330 3698 3955 4140 4775 2245 2302 703 964 983 1159 696 692 1126 1148 1128 1028 955 920 658 399 358 491 686 938 1274 1356 1243
1656 1546 1453 1810 1737 1600 1558 1222 1129 1185 1227 1530 2007 2681 2580 2288 1725 1401 1344 1729 4892 4580 4326 4194 4520 5066 4817 1792 1922 2773 2866 3069 3134 3902 3799 2442 1652 1543 2162 2378 2369 2078 1805 2954 3153 2929 3580 3689 4749 4082 3748 1949
5510 5455 5179 4443 4395 4870 4975 5270 5479 5285 5191 5373 5383 5354 5313 5267 5253 5163 5114 5091 5047 4903 4869 4615 4442 4009  4837 5535 3193 3790 3017 2082 2128 3836 3539 4409 4450 4843 5532 5533 5534 4204 3855 5019 4564 4171 1687
4158 3839 3482 2941 2812 2644 2256 2319 2280 2350 2313 1978 1693 1477 1560 1473 1366 1310 1330 1322 1449 1583 3588 2983 3012 2568 2550 2535 2486 1655 1469 1404 859 749 734 733 779 847 1003 1152 1210 1090 974 987 732 754 657 622 677 821 512 443 442 140 124 164 118 129 267 334 354 252 215 286 315 370 367
}
impassable_terrain = LIST { 3663 3768 3281 3000 2390 3984 1723 1043 1717 2861 3074 3577 3641 3968 3277 2776 3036 5153 4968 5560 5576 5605 5611 }

wasteland = LIST { 348 1283 1476 5418 5116 1627 2346 1668 1067 1099 2034 2772 598 257 897 1167 
4960 4979 5028 4992 4982 5043 5035 5204 5241 5275 5287 5323 5392 5421 5374 5358 5328 5368 5412 5338 5406 5386 
5016 5133 5073 5087 5182 5146 5306 5369 5272 5246 5292 5414 5447 5454 5463 5457 5345 5473 5484 5477 5499 5485
5126 5120 5211 5260 5320 5322 5362 5372 5391 5408 5429 5431 5452 5436 5385 5337 
5403 5464 5424 5468 5482 5496 5491 5423 5359 5298 5324 5343 5291
5522 5516 5525 5517 5505 5511 5497 5495 5494 5501 5500 5520 5486 5487 5492 5502 5508 5512 5524 5504 5488 5472 5489
5274 5205 5252 5233 5160 5162 4838 4793 4611 4653 4694 4802 4976 5050 5080 5150 5238
4733  4973 4657 4526 4471 4511 4742 4506 4360 4301 4529 4753 4851 4914 4902 4754 4832 4939 4936 4974 4969
5340 5316 5271 5217 5223 5259 5300 5334 5297 5286 5234 5222 5167 5089 5151 5228 
4875 4891 4876 4944 4925 5011 5002 5042 5010 5001 5022 5250 5125 5170 5174 5090 5185 5062 5063
4959 4955 4883 4981 4897 4774 4862 4717 4741 4718 4673 4808 4518 4635 4426 4364 4320 4325 4352 4393 4394 4389 4414 4481 4388 4505 4365 
4544 4636 4592 4478 4664 4110 4127 4258 3894 3627 3741 4162 3329 2405 2691 3964 3823 3531 3350 3195 2991 2841 2977 3075 2741 2896 2856 3062 3085 4537 3396
3203 3288 3885 3776 3807 3586 3476 3389 3319 3271 3540 3587 3320 3194 3165 3272 3287 3164 3128 3181 3140 3061 3856 3798 3674 3642 3423
3321 3211 3220 3274 3410 3263 3273 3188 3628 3519 3440 3334 3368 3159 3147 3233 3141 3005 2910 2848 2745 2600 2530 2667 2716  2615 2653 2746 2835 2660 2674 2703
3497 3385 2947 2955 2840 2834
1565 1603 1702 1820 1747 1695 1770 2031 2107 2132 2099 2153 2186 2235 2320 1980 1942 1809 1818 1735 1664 1630 1620 1615
1823 1873 1856 1786 1900 1819 1933 2019 2136 2212 2013 2068 1941 1989 1888 2052 2045 2171 2165 2221 2239 2275 2332 2303 2370 2406 2459
2454 2431 2430 2400 2271 2164 2291 1961 1917 2046 2059 1908 2281 2177 2185 2058 1934 2308 2386 2420 2380 2234 2174 1968 2140 2202 2272 2244
2093 2416 2331 2287 2371 2476 2492 2531 2455 2645 2616 2635 2747 2723 2783 2724 2858 2807 2857 2539 2608
2585 2545 2536 2754 2730 2903 2722 2586 2475 2506 2351 2393 2601 2606 2618 2453 2579 2352 2423 2537 2458 2502 2661 2777 2766 2765 2911 2930
3041 3078 3182 3279 3294 3379 3289 3228 3403 3498 3499 2823 3030 3053 3196 3129 3335 3369 3174 3183 3275 3524 3560 3525 3417 3166 3013
2876 2619 3007 2836 2959 2842 3086 3234 3344 3424 3456 3483 3372 2925 2898 2897 3063 3189 2960 3283 3175 3322
3791 3719 3962 4010 4116 3928 3935 3901 3818 3714 4755 4674 4538 4605 4724 4390 4427 4232 3197 3021 3054 3014 4083 
4308 4285 3796 3713 4598 4428 4399 4313 4218 4029 3754 3721 3770 3863 3929 4052 4200 4223 4249 4166 4205 4074 3881 3862
4061 3944 3990 4028 3777 3707 3643 3720 3655 3569 3612 3477 3873
1872 1816 1753 1838 1796 1736 1722 1798 1822 1940 2012 1906 1920 1914 1855 2000 1993 1929 1931 2053 2091 2074 1974
2148 2209 2226 2195 2337 2296 2205 2201 2330 2233 2184 2176 2196 2216 2129 2023 1898 2030 2044 2163 2158 2001 2117 1979
1862 1791 1824 1760 1598 1612 1644 1721 1700 1658 1624 1593 1590 1663 1728 1807 1865 1858 1780 1994 1817 1861 1907
1834 1741 1677 1769 1751 1642 1711 1637 1535 1591 1606 1542 1557 1518 1517 1462 2197 2257  2379 1501 1399 1406 1340 1316
1513 1524 1465 1456 1424 1370 1362 1384 1290 1319 1204 1211 1269 1343 1352 1306 1245 1265 1277 1315 1264 1286 1040 1107 1052
1079 1131 1136 2225 1619 1643 1470 1418 1273 1181 1843 2035 2286 1880 1797 1698 2441 2498
412 444 460 503 467 533 570 676 701 726 781 804 818 688 844 910 915 976 766 785 710 742 761 794 837 728 777 553 601 618 583 605 597 548 
647 617 525 589 659 706 547 610 650 735 737 725 708 646 661 649 700 741 747 789 799 800 811 812 894 848 891 884 917 933 934 991 992 994 1041
1030 1053 1066 1094 625 563 564 575 680 865 892 866 885 879 924 959 953 1000 975 1080 1084 1010 1004 928 893 1068 1155 1145 1170 1158 1104 1006
988 1073 1023 1112 1116 1184 1142 1162 1196 1171 1256 1111 1069 1166 1122 1176 1234 1325 1299 1238 1220 1360 1246 1329 1341  1372 1175 1064 1081 914 1019 950
1063 1095 1161 1165 1237 1312 1338 1348 1364 1377 1433 1386 1496 1519 1474 1450 1438 1412 1392 1451 1525 1540 1528 1607 1645 1608 1599 1694 1422 1563 1635 1629 1696 1701
1425 1385 1371 1413 1400 1483 1754 1776 1859 1932 1921 1995 2064 2006 2092 1731 1774 1746 1765 1688 1618 1647 1596 1574 2189
234 236 269 194 180  174 157 205 165 247 268 307 300 353 372 356 397 383 424 409 271 201 226 183 327 316 280 339 371 398 376 359 324 293 306
278 389 433 419 486 490 471 494 505 518 530 513 523 536 540 532 506 1328 1295 1255 1285 1268 1281 1318 1296 1297 1284 1203 1207 1236 1192 1141 1119
1224 1151 1065 999 871 817 831 958 1060 1087 755 717 667 694 648 641 592 524 608 713 727 699 678 244 296 225 276 325 472
1103 1169 1180 1233 1216 1217 466 552 587 578 624 609 630 546 531 588 633 582 635 636 562 679 718 350 516 695
810 864 904 912 970 957 1056 1115 1093 1186 1202 1205 1206 1194 1140 1150 1223 1226 1280 1260 1149
1244 1289 1276 1353 1375 1390 1391 1380 1381 1358 1376 1444 1445 1421 1493 1452 1430 1427 1403
1507 1527 1568 1534 1605 1308 932 850 740 721 687 
92 72 54 75 95 119 115 79 50 45 52 108 83 90 49 44 69 89 122 132 128 98 70 123 147 150 189 209 229
246 266 243 260 279 176 328 326 303 305 347 340 366 385 394 402 416 483 543 591 407 408 404 464 387
159 289 369 379 392 368 390 406 452 473 414 422 458 427 455 521 585 434 446 463 493 384 476 508
656 603 584 581 620 640 580 619 645
}

uninhabitable = LIST { 1198 }

#Major Rivers
river_provinces = LIST { 5672 5673 5674 5675 5676 5677 5678 5679 5680 5681 5682 5683 5684 5685 5686 5687 5688 5689
5690 



 } # Baetep River






